177 11
 1 2 9 10 3 4 1 2 1 2 9 10 3 4 1 2 1 2 9 10 11 12 1 2 1 2 9 10 3 4 1 2 5 6 9 10 3 4 5 6 1 2 1 2 1 2 1 2 9 10 3 4 70 70 9 10 41 42 1 2 1 2 5 6 9 10 5 6 9 10 5 6 9 10 5 6 9 10 1 2 5 6 1 2 41 42 41 42 1 2 70 70 9 10 48 85 91 8 8 8 8 8 9 10 8 8 8 8 8 8 8 8 9 10 8 8 9 10 8 8 8 8 8 8 8 8 50 50 1 2 1 2 9 10 41 42 1 2 9 10 5 6 1 2 9 10 3 4 92 69 79 38 1 2 39 20 9 10 79 38 1 2 39 20 9 10 79 38 1 2 11 12 5 6 48 85 85
 21 22 9 10 23 24 89 90 61 62 9 10 23 24 89 90 61 62 9 10 11 54 89 90 61 62 9 10 23 24 89 90 21 22 9 10 23 24 70 70 61 62 61 62 61 62 61 62 9 10 63 64 70 70 9 10 61 62 61 62 61 62 21 22 9 10 70 70 9 10 70 70 9 10 70 70 9 10 61 62 70 70 61 62 61 62 61 62 61 62 70 70 9 10 8 53 53 8 8 74 8 8 9 10 8 8 57 8 57 8 57 8 9 10 8 74 9 10 8 8 8 8 57 8 57 8 8 53 61 62 21 22 9 10 61 62 61 62 9 10 70 70 61 62 9 10 23 24 21 22 61 62 33 34 19 59 9 10 96 97 33 34 19 59 9 10 96 97 33 34 11 54 70 70 28 85 85
 41 42 9 10 43 44 5 6 1 2 9 10 43 44 5 6 1 2 9 10 3 4 5 6 1 2 9 10 43 44 5 6 41 42 9 10 43 44 70 70 1 2 1 2 1 2 1 2 9 10 81 82 70 70 9 10 1 2 1 2 1 2 41 42 9 10 70 70 9 10 70 70 9 10 70 70 9 10 1 2 70 70 1 2 1 2 1 2 1 2 70 70 9 10 8 53 53 8 40 92 8 8 9 10 8 8 8 8 8 8 8 8 9 10 40 92 9 10 8 8 8 8 8 8 8 8 8 53 1 2 41 42 9 10 1 2 1 2 9 10 70 70 1 2 9 10 43 44 41 42 1 2 9 10 39 20 9 10 79 38 9 10 39 20 9 10 79 38 9 10 3 4 70 70 48 85 85
 61 62 9 10 63 64 70 70 61 62 9 10 23 24 70 70 61 62 9 10 23 24 70 70 61 62 9 10 23 24 70 70 61 62 9 10 23 24 70 70 61 62 61 62 51 52 45 7 29 30 82 82 32 32 32 32 71 68 13 14 61 62 61 62 9 10 70 70 9 10 70 70 9 10 70 70 9 10 89 90 70 70 61 62 51 52 45 7 32 32 79 80 29 30 8 53 53 8 8 8 8 8 29 30 8 8 8 8 15 16 15 16 9 10 15 16 9 10 8 8 8 74 8 8 8 8 8 53 79 80 32 32 32 32 71 68 13 14 9 10 70 70 61 62 9 10 63 64 61 62 61 62 9 10 61 62 9 10 61 62 9 10 61 62 9 10 89 90 9 10 63 64 70 70 8 53 53
 1 2 9 10 81 82 70 70 1 2 9 10 43 44 70 70 1 2 9 10 43 44 70 70 1 2 9 10 43 44 70 70 1 2 9 10 43 44 70 70 1 2 1 2 31 45 46 50 50 50 50 50 50 50 50 50 50 75 84 82 1 2 1 2 9 10 70 70 9 10 70 70 9 10 70 70 9 10 5 6 70 70 1 2 31 45 46 50 50 50 50 50 50 50 50 50 50 50 50 50 50 50 50 30 8 8 8 8 35 36 35 36 9 10 35 36 9 10 8 8 40 92 8 50 50 50 50 50 50 50 50 50 50 50 50 75 84 90 9 10 70 70 1 2 9 10 79 80 1 2 1 2 9 10 1 2 9 10 1 2 9 10 1 2 9 10 5 6 9 10 79 80 70 70 8 53 53
 61 62 9 10 61 62 70 70 61 62 9 10 63 64 70 70 89 90 9 10 23 24 70 70 61 62 9 10 63 64 70 70 61 62 9 10 23 24 70 70 51 52 45 7 25 46 27 26 9 10 61 62 21 22 9 10 72 88 83 67 79 80 32 32 9 10 70 70 9 10 70 70 9 10 70 70 9 10 21 22 70 70 51 52 73 46 27 26 61 62 61 62 33 34 28 85 91 8 15 16 15 16 9 10 8 8 32 55 8 8 15 16 17 37 17 37 50 50 8 8 32 55 8 8 8 74 77 78 11 54 61 62 33 34 72 88 83 67 32 32 79 80 32 32 32 32 71 68 13 14 61 62 9 10 61 62 9 10 61 62 9 10 61 62 9 10 21 22 9 10 51 52 45 7 8 53 53
 1 2 9 10 1 2 70 70 1 2 9 10 81 82 70 70 5 6 9 10 43 44 70 70 1 2 9 10 81 82 70 70 1 2 9 10 43 44 70 70 31 45 46 50 50 50 65 66 9 10 1 2 41 42 9 10 92 69 50 50 50 50 50 35 9 10 70 70 9 10 70 70 9 10 70 70 9 10 41 42 70 70 31 45 46 47 65 66 1 2 1 2 9 10 48 85 91 8 35 36 35 36 9 10 50 50 50 75 76 8 35 36 37 37 37 37 33 34 50 50 50 75 76 8 40 92 77 78 3 4 1 2 9 10 2 69 50 50 50 50 50 50 50 50 50 50 50 75 84 90 1 2 9 10 1 2 9 10 1 2 9 10 1 2 9 10 41 42 9 10 31 45 46 50 50 50 50
 61 62 9 10 61 62 70 70 89 90 9 10 61 62 70 70 21 22 9 10 63 64 70 70 61 62 9 10 61 62 70 70 21 22 9 10 63 64 51 52 73 46 27 26 89 90 61 62 9 10 61 62 61 62 9 10 61 62 9 10 89 90 89 90 9 10 70 70 9 10 70 70 9 10 70 70 9 10 89 90 51 52 73 46 27 26 89 90 61 62 61 62 9 10 28 85 91 8 8 8 8 8 9 10 15 16 9 10 83 55 8 8 17 37 17 37 9 10 15 16 9 10 83 55 8 8 77 78 63 64 61 62 9 10 61 62 89 90 9 10 21 22 9 10 21 22 72 88 83 84 13 14 9 10 61 62 9 10 61 62 9 10 61 62 9 10 61 62 9 10 25 46 27 26 28 85 85
 1 2 9 10 1 2 70 70 5 6 9 10 1 2 70 70 41 42 9 10 81 82 70 70 1 2 9 10 1 2 70 70 41 42 9 10 81 82 31 45 46 47 65 66 5 6 1 2 9 10 1 2 1 2 9 10 1 2 9 10 5 6 5 6 9 10 70 70 9 10 70 70 9 10 70 70 9 10 5 6 31 45 46 47 65 66 5 6 1 2 1 2 9 10 48 85 91 8 8 8 8 8 9 10 35 36 9 10 56 83 76 8 35 37 37 37 9 10 35 36 9 10 56 83 76 8 77 78 81 82 1 2 9 10 1 2 5 6 9 10 41 42 9 10 41 42 92 69 58 83 84 90 9 10 1 2 9 10 1 2 9 10 1 2 9 10 1 2 9 10 50 35 65 66 48 85 85
 79 80 29 30 79 80 79 80 79 80 29 30 79 80 79 80 79 80 29 30 79 80 79 80 79 80 29 30 79 80 79 80 79 80 29 30 79 80 25 46 79 80 79 80 79 80 79 80 29 30 79 80 79 80 29 30 79 80 29 30 79 80 79 80 29 30 79 80 29 30 79 80 29 30 79 80 29 30 79 80 25 46 79 80 79 80 79 80 79 80 79 80 29 30 49 85 91 8 32 55 8 8 29 30 8 8 29 30 8 60 83 18 35 37 17 37 29 30 32 55 29 30 8 60 83 18 77 78 79 80 79 80 29 30 79 80 79 80 29 30 79 80 29 30 79 80 79 80 79 80 83 67 29 30 79 80 29 30 79 80 29 30 79 80 29 30 79 80 29 30 79 80 79 80 49 85 85
 50 50 50 50 50 50 50 50 50 50 50 50 50 50 50 50 50 50 50 50 50 50 50 50 50 50 50 50 50 50 50 50 50 50 50 50 50 50 50 50 50 50 50 50 50 50 50 50 50 50 50 50 50 50 50 50 50 50 50 50 50 50 50 50 50 50 50 50 50 50 50 50 50 50 50 50 50 50 50 50 50 50 50 50 50 50 50 50 50 50 50 50 50 50 50 50 50 50 50 83 50 50 50 50 50 50 50 50 50 50 50 50 37 37 37 37 50 50 50 75 50 50 50 50 50 50 50 50 50 50 50 50 50 50 50 50 50 50 50 50 50 50 50 50 50 50 50 50 50 50 50 50 50 50 50 50 50 50 50 50 50 50 50 50 50 50 50 50 50 50 50 50 50 50 50 50 50
6
1 1585 145 3 1588 -20
1 1595 145 3 1588 -20
1 1605 145 3 1588 -20
1 1904 145 3 1904 -20
1 1920 145 3 1904 -20
1 1935 145 3 1904 -20