48 10
 1 1 2 3 2 3 2 3 2 3 2 3 1 1 1 1 1 1 2 3 2 3 2 3 2 3 2 3 1 1 1 1  1 1 1 1 1 1 1 1 33 34 35 37 35 37 36 50 
 4 6 4 6 4 6 4 6 4 6 4 6 1 1 1 1 4 6 4 6 4 6 4 6 4 6 4 6 1 1 1 1  1 1 1 1 1 1 1 1 50 50 34 38 34 38 29 50 
 7 5 7 5 7 5 7 5 7 5 7 5 2 3 2 3 7 5 7 5 7 5 7 5 7 5 7 5 2 3 2 3  2 3 2 3 2 3 2 3 50 40 39 38 39 38 31 50 
 4 6 8 9 4 6 4 6 4 6 4 6 4 6 4 6 4 6 8 9 4 6 4 6 4 6 4 6 4 6 4 6  4 6 4 6 8 9 8 9 50 34 41 42 34 38 43 50 
 7 5 10 11 7 5 7 5 7 5 7 5 7 5 7 5  7 5 10 11 7 5 7 5 7 5 7 5 7 5 7 5  7 5 7 5 10 11 10 11 50 51 44 50 39 38 36 50 
 8 9 50 50 8 9 8 9 8 9 8 9 8 9 8 9  8 9 50 50 8 9 8 9 8 9 8 9 8 9 8 9  8 9 8 9 50 50 50 50 50 34 43 50 34 38 29 50 
 10 11 17 18 10 11 10 11 10 11 10 11 10 11 10 11 10 11 17 18 10 11 10 11 10 11 10 11 10 11 10 11 10 11 10 11 17 18 50 50 50 51 36 50 39 38 31 50 
 12 13 19 20 50 50 12 13 12 13 50 50 12 13 50 50 12 13 19 20 50 50 12 13 12 13 50 50 12 13 50 50 50 50 50 50 19 20 50 50 50 51 45 50 51 38 29 50 
 14 15 21 22 23 24 14 15 14 15 23 24 14 15 23 24 14 15 21 22 23 24 14 15 14 15 23 24 14 15 23 24 23 24 25 48 21 22 49 26 27 46 47 50 47 38 31 50 
 16 16 16 16 16 16 16 16 16 16 16 16 16 16 16 16 16 16 16 16 16 16 16 16 16 16 16 16 16 16 16 16 16 16 16 16 16 16 16 16 16 16 16 16 16 16 16 16 